1111111111111
10010000000C1
1000011111001
10000110PE101
1111111111111